####################
# .......##........#
#.##.##..##..##.##.#
#................. #
#.##.#..####..#.##.#
#....#...##...#....#
####.###.##.###.####
   #.#........#.#
   #.#.##--##.#.#
####...#ABCD#...####
.......#    #.......
####.#.######.#.####
   #.#........#.#
   #.#.######.#.#
####.....##.....####
#........##........#
#.##.###.##.###.##.#
#..#............#..#
##.#.#.######.#.#.##
#....#...##...#... #
#.######.##.######.#
# .................#
####################
