####################
#@.......##........#
#.##.##..##..##.##.#
#.................@#
#.##.#..####..#.##.#
#....#...##...#....#
####.###.##.###.####
   #.#........#.#
   #.#.##--##.#.#
####...#    #...####
   #...#    #...#
####.#.######.#.####
   #.#........#.#
   #.#.######.#.#
####.....##.....####
#........##........#
#.##.###.##.###.##.#
#..#............#..#
##.#.#.######.#.#.##
#....#...##...#...@#
#.######.##.######.#
#@.................#
####################
