###################
#                 #
# ### # ### # ### #
# ### #     # ### #
# ### # # # # ### #
#     # # # #     #
# ##### # # ##### #
# #             # #
# # ##### ##### # #
#                 #
# ##### ### ##### #
#       ###       #
# ### # ### # ### #
# ### #     # ### #
# ### # ### # ### #
#     # ### #     #
# ##### ### ##### #
#                 #
###################